05 05 05 05 05 05 05 05 05 05 05 05 05 05 05 05 05 05 05 05 05 05 05 05 05 05 05 05 05 05 05 05 05 05 05 05 05 05 05 05 05 05 05 05 05 05 05 05 05 05
05 12 05 05 05 05 05 05 05 05 05 05 05 05 05 05 05 05 05 05 05 05 05 05 05 05 05 05 05 05 05 05 05 05 05 05 05 05 05 05 05 05 05 05 05 05 05 05 05 05
05 05 05 05 05 05 05 05 05 05 05 05 05 05 05 05 05 05 05 05 05 05 05 05 05 05 05 05 05 05 05 05 05 05 05 05 05 05 05 05 05 05 05 05 05 05 05 05 05 05
05 05 05 05 05 05 05 05 05 05 05 05 05 05 05 05 05 05 05 05 05 05 05 05 05 05 05 05 05 05 05 05 05 05 05 05 05 05 05 05 05 05 05 05 05 05 05 05 05 05
05 05 05 12 05 05 05 05 05 05 05 05 05 05 05 05 05 05 05 05 05 05 05 05 05 05 05 05 05 05 05 05 05 05 05 05 05 05 05 05 05 05 05 05 05 05 05 05 05 05
05 11 11 11 11 11 11 11 11 11 11 11 11 11 11 11 11 11 11 11 11 11 11 11 11 11 11 11 11 11 11 11 11 11 11 11 11 05 05 05 05 05 05 05 05 05 05 05 05 05
05 11 11 11 11 11 11 11 11 11 11 19 18 18 18 18 18 18 18 20 11 11 11 11 11 11 11 11 11 11 11 05 05 05 05 05 05 05 05 05 05 05 05 05 05 05 05 05 05 05
05 11 11 11 11 11 11 11 11 11 11 19 18 18 18 18 18 18 18 20 11 11 11 11 11 11 11 11 11 11 11 11 11 11 05 05 05 05 05 05 05 05 05 05 05 05 05 05 05 05
05 11 11 13 11 11 11 11 11 11 11 11 14 14 14 14 14 14 14 11 11 11 11 11 11 11 11 11 11 11 11 11 11 11 05 05 05 05 05 05 05 05 05 05 05 05 05 05 05 05
05 11 18 18 18 14 11 11 11 11 11 11 14 14 15 14 14 14 14 11 11 11 11 11 11 11 11 11 11 11 11 11 11 11 05 05 05 05 05 05 05 05 05 05 05 05 05 05 05 05
05 11 18 18 18 14 11 11 11 11 11 11 13 11 15 11 12 11 11 11 11 11 11 11 11 05 05 05 05 05 05 05 05 05 05 05 05 05 05 05 05 05 11 11 11 11 11 11 11 11
05 11 18 18 18 14 11 11 11 11 11 12 11 11 16 11 11 11 11 11 11 11 11 11 05 05 05 05 05 05 05 05 05 11 05 05 05 05 05 05 05 05 11 11 11 11 11 11 11 11
05 11 18 18 18 15 11 11 11 11 11 11 12 11 15 17 15 15 16 17 17 11 11 11 05 05 05 05 05 05 05 05 05 05 05 05 05 05 05 05 05 05 11 11 11 11 11 11 11 11
05 11 18 18 18 14 11 11 11 11 11 11 11 13 11 13 11 11 11 11 11 11 11 11 11 11 11 11 11 11 05 05 05 05 05 11 05 05 05 05 05 05 05 05 05 05 05 05 05 11
05 11 11 11 11 11 11 11 11 11 11 11 11 11 11 11 11 11 11 11 11 11 11 11 11 05 05 11 11 11 11 05 05 05 05 05 05 05 05 05 05 05 05 05 05 05 05 05 05 11
05 11 18 18 18 14 11 11 11 11 11 11 11 11 11 11 11 11 11 11 11 11 11 11 11 11 05 05 11 11 11 05 05 11 05 05 05 05 05 05 05 05 05 05 05 05 05 05 05 11
05 11 18 18 18 14 11 11 11 11 11 11 11 11 11 11 11 11 11 11 11 11 11 11 11 05 05 11 11 11 11 05 05 05 05 05 05 05 05 05 05 05 05 05 05 05 05 05 05 11
05 11 18 18 18 14 11 11 11 11 11 11 11 11 11 11 11 11 11 11 11 11 11 11 05 05 05 05 11 11 11 05 11 05 05 05 11 05 05 05 05 05 05 11 05 05 05 11 05 05
05 11 18 18 18 15 11 11 11 11 11 11 11 11 11 11 11 11 11 11 11 11 11 11 05 05 05 05 11 11 11 11 05 11 05 11 11 05 05 05 05 05 01 01 01 05 05 05 11 05
05 11 18 18 18 14 11 11 11 11 11 11 11 11 11 11 11 11 11 11 11 11 11 11 05 05 05 05 05 11 11 11 11 05 05 05 05 05 05 05 05 05 14 15 14 05 05 05 05 11
05 11 11 11 11 11 11 11 11 11 11 11 11 11 11 11 11 11 11 11 11 11 11 11 05 11 05 05 05 11 11 11 11 11 11 05 11 05 05 05 11 11 11 11 11 11 05 05 05 05
05 11 11 11 11 11 11 11 11 11 11 11 11 11 11 11 11 11 11 11 11 11 11 11 11 11 05 05 05 11 11 11 11 11 11 11 05 11 05 05 11 11 11 11 11 11 05 05 05 05
05 11 18 18 18 14 11 11 11 11 11 11 11 11 11 11 11 11 11 11 11 11 11 11 11 05 05 05 05 05 11 11 11 11 11 11 11 05 05 11 11 11 11 11 11 05 05 05 05 05
05 11 18 18 18 15 11 11 11 11 11 11 11 11 11 11 11 11 11 11 11 11 11 11 05 05 05 05 05 05 05 11 11 11 11 11 11 11 11 11 11 11 11 11 11 11 11 11 11 11
05 11 18 18 18 14 11 11 11 11 11 11 11 11 11 11 11 11 11 11 11 11 11 11 11 05 05 05 05 05 05 05 05 05 05 05 05 11 11 11 11 11 11 11 11 05 05 05 05 05
05 11 18 18 18 14 11 11 11 11 11 11 11 11 11 11 11 11 11 11 11 11 11 11 11 11 05 05 05 05 05 05 05 05 05 05 05 05 05 05 05 05 05 05 05 05 05 05 05 05
05 11 18 18 18 14 11 11 11 11 11 11 11 11 11 11 11 11 11 11 11 11 11 11 11 11 11 05 05 05 05 05 05 05 05 05 05 05 05 05 05 05 05 05 05 05 05 05 05 11
05 11 11 11 11 11 11 11 11 11 11 11 11 11 11 11 11 11 11 11 11 11 11 11 11 11 11 05 05 05 05 05 05 05 05 05 05 05 05 05 05 05 05 05 05 05 05 05 05 11
05 11 11 11 11 11 11 11 11 11 11 11 15 11 11 11 11 11 15 11 11 11 11 11 11 11 05 05 05 05 05 05 05 05 05 05 05 05 05 05 05 05 05 05 05 05 05 05 11 11
05 11 11 11 11 11 11 11 11 18 18 18 21 18 11 11 11 18 21 18 18 18 05 11 05 11 11 11 11 11 11 11 05 05 05 05 05 05 05 05 05 05 05 05 05 05 05 05 05 05
05 11 11 11 11 11 11 11 11 18 18 18 18 18 11 11 11 18 18 18 18 18 11 05 11 11 11 11 11 11 11 11 11 11 11 11 05 05 05 05 05 05 05 05 05 05 05 05 05 05
05 05 05 05 05 05 05 05 05 18 18 18 18 18 05 05 05 18 18 18 18 18 05 05 05 05 05 05 05 05 05 05 05 05 05 05 05 05 05 05 05 05 05 05 05 05 05 05 05 05
05 05 05 05 05 05 05 05 05 05 05 05 05 05 05 05 05 05 05 05 05 05 05 05 05 05 05 05 05 05 05 05 05 05 05 05 05 05 05 05 05 05 05 05 05 05 05 05 05 05 
05 05 05 05 05 05 05 05 05 05 05 05 05 05 05 05 05 05 05 05 05 05 05 05 05 05 05 05 05 05 05 05 05 05 05 05 05 05 05 05 05 05 05 05 05 05 05 05 05 05 
05 05 05 05 05 05 05 05 05 05 05 05 05 05 05 05 05 05 05 05 05 05 05 05 05 05 05 05 05 05 05 05 05 05 05 05 05 05 05 05 05 05 05 05 05 05 05 05 05 05 
05 05 05 05 05 05 05 05 05 05 05 05 05 05 05 05 05 05 05 05 05 05 05 05 05 05 05 05 05 05 05 05 05 05 05 05 05 05 05 05 05 05 05 05 05 05 05 05 05 05 
05 05 05 05 05 05 05 05 05 05 05 05 05 05 05 05 05 05 05 05 05 05 05 05 05 05 05 05 05 05 05 05 05 05 05 05 05 05 05 05 05 05 05 05 05 05 05 05 05 05 
05 05 05 05 05 05 05 05 05 05 05 05 05 05 05 05 05 05 05 05 05 05 05 05 05 05 05 05 05 05 05 05 05 05 05 05 05 05 05 05 05 05 05 05 05 05 05 05 05 05 
05 05 05 05 05 05 05 05 05 05 05 05 05 05 05 05 05 05 05 05 05 05 05 05 05 05 05 05 05 05 05 05 05 05 05 05 05 05 05 05 05 05 05 05 05 05 05 05 05 05 
05 05 05 05 05 05 05 05 05 05 05 05 05 05 05 05 05 05 05 05 05 05 05 05 05 05 05 05 05 05 05 05 05 05 05 05 05 05 05 05 05 05 05 05 05 05 05 05 05 05 
05 05 05 05 05 05 05 05 05 05 05 05 05 05 05 05 05 05 05 05 05 05 05 05 05 05 05 05 05 05 05 05 05 05 05 05 05 05 05 05 05 05 05 05 05 05 05 05 05 05 
05 05 05 05 05 05 05 05 05 05 05 05 05 05 05 05 05 05 05 05 05 05 05 05 05 05 05 05 05 05 05 05 05 05 05 05 05 05 05 05 05 05 05 05 05 05 05 05 05 05 
05 05 05 05 05 05 05 05 05 05 05 05 05 05 05 05 05 05 05 05 05 05 05 05 05 05 05 05 05 05 05 05 05 05 05 05 05 05 05 05 05 05 05 05 05 05 05 05 05 05 
05 05 05 05 05 05 05 05 05 05 05 05 05 05 05 05 05 05 05 05 05 05 05 05 05 05 05 05 05 05 05 05 05 05 05 05 05 05 05 05 05 05 05 05 05 05 05 05 05 05 
05 05 05 05 05 05 05 05 05 05 05 05 05 05 05 05 05 05 05 05 05 05 05 05 05 05 05 05 05 05 05 05 05 05 05 05 05 05 05 05 05 05 05 05 05 05 05 05 05 05 
05 05 05 05 05 05 05 05 05 05 05 05 05 05 05 05 05 05 05 05 05 05 05 05 05 05 05 05 05 05 05 05 05 05 05 05 05 05 05 05 05 05 05 05 05 05 05 05 05 05 
05 05 05 05 05 05 05 05 05 05 05 05 05 05 05 05 05 05 05 05 05 05 05 05 05 05 05 05 05 05 05 05 05 05 05 05 05 05 05 05 05 05 05 05 05 05 05 05 05 05 
05 05 05 05 05 05 05 05 05 05 05 05 05 05 05 05 05 05 05 05 05 05 05 05 05 05 05 05 05 05 05 05 05 05 05 05 05 05 05 05 05 05 05 05 05 05 05 05 05 05 
05 05 05 05 05 05 05 05 05 05 05 05 05 05 05 05 05 05 05 05 05 05 05 05 05 05 05 05 05 05 05 05 05 05 05 05 05 05 05 05 05 05 05 05 05 05 05 05 05 05 
05 05 05 05 05 05 05 05 05 05 05 05 05 05 05 05 05 05 05 05 05 05 05 05 05 05 05 05 05 05 05 05 05 05 05 05 05 05 05 05 05 05 05 05 05 05 05 05 05 05 